%%%%%%%%%%%%%%%%%%%%%%%%%%%%%%%%%
%%%%%%%%%%%%%%%%%%%%%%%%%%%%%%%%%
%%%%%%%%%%%%%%%%%%           %%%%
%%%%%%%   %%%%%%%%%%%%%%%%%%%%%%%
%%%%%%%    %%%%%%%%%%%%%%%%%%%%%%
%%%%%%%     %%%%%%%%%%%%%%%%%%%%%
%%%%%%%%%%%%%%%%%%%%%%%%%%%%%%%%%
%%%%%%%%%%%%%%%%%%%%%%%%%%%%%%%%%
%%%%%%%%%%%%%%%%%  %%%%%%%%%%%%%%
%%%%               %%%%%%%%%%%%%%
%%%%                %%%%%%%%%%%%%
%%%%                %%%%%%%%%%%%%
%%%%                 %%%%%%%%%%%%
%%%%%%%%%%%%%%%%%%%%%%%%%%%%%%%%%
%%%%%%%%%%%.......%%%%%%%%%%%%%%%
%%%%%%%%%%%.......%%%%%%%%%%%%%%%
%%%%%%%%%%%%%%%%%%%%%%%%%%%%%%%%%
%%%%                  %%%%%%%%%%%
%%%%     %%%%%%%%%%%%%%%%%%%%%%%%
%%%%    %%%%%%%%%%%%%%%%%%%%%%%%%
%%%%   %%%%%%%%%%%%%%%%%%%%%%%%%%
%%%%  %%%%%%%%%%%%%%    %%%%%%%%%
%%%% %%%%........%%%    %%%%%%%%%
%%%%%%%%%........%%%    %%%%%%%%%
%%%%%%%%%%%%%%%%%%%%%%%%%%%%%%%%%
%%%%%%%%%%%%%%%%%%%%%%%%%%%%%%%%%
%%%%%%%%%%%%%%%%%%%%%%%%%%%%%%%%%
#
%%%%%%%%%%%%%%%%%%%%%%%%%%%%%%%%%
%%%%%%%%%%%%%%%%%%%%%%%%%%%%%%%%%
%%%%%%%%%%%%%%%%%%%%%%%%%%%%%%%%%
%%%%%P%%%%%%%%%%%%%%%%%%%%%%%% %%
%%%%%        %%%%%%%%%%%%%%%%%%%%
%%%%%%%%%%%%%%%%%%%%%%%%%%%%%%%%%
%%%%%%%%%%%%%%%%%%%%%%%%%%%%%%%%%
%%%%%%%%%%%%%%%%%%%%%%%%%  %%%%%%
%%%%%%%%%%%%%%%%%%%%%%%%%  %%%%%%
%%%%%%%%%%%%%%       %%%%%  %%%%%
%%%                  %%%%%  %%%%%
%%%                   %%%%% %%%%%
%%%  %%%%%%%%%%%%%%%%%%%%%%  %%%%
%%%  %%%%%%%%...%%%%%%%%%%%% %%%%
%%% %%%%%%%%....%%%%%%%%%%%% %%%%
%%% %%%%%%%%....%%%%%%%%%%%% %%%%
%%%  %%%%%%%%..%%%%%%%%%%%%% %%%%
%%%   %%%%%%%%%%%%%%%%%%%%%%%%%%%
%%%        %%%%%%%%%%%%%%%%%%%%%%
%%%       %%%%%%%%%%%%%%%%%%%%%%%
%%%      %%%%%%%%%%%%%%%%%%%%%%%%
%%%     %%%....%%%%%%%%%%%%%%% %%
%%%    %%%%....%%%        %%%% %%
%%%   %%%%%....%%%%%%%%%%%%%%% %%
%%%%%%%%%%%....%%%%%%%%%%%%%%%%%%
%%%%%%%%%%%%%%%%%%%%%%%%%%%%%%%%%
%%%%%%%%%%%%%%%%%%%%%%%%%%%%%%%%%
#
%%%%%%%%%%%%%%%%%%%%%%%%%%%%%%%%%
%%%%%%%%%%%%%%%%%%%%%%%%%%%%%%%%%
%%%%%%%%%%%%%%%%%%%%%%%%%%%%%%%%%
%%%%%%%%%%%%%%%%%%%%%%%%%%%%%%%%%
%%%%%%%%%%%%%%%%%%%%%%%%%%%%%%% %
%%%%%%%%%%%%%%%%%%%%%%%%%%%%%%% %
%%%%%%%%%%%%%%%%%%%%%%%%%%%%%%% %
%%%%%%%%%%%%%%%%%%%%%%%%%%%%%%%%%
%%%%%%%%%%%%%%%%%%%%%%%%%  %%%%%%
%%%%%%%%%%%%%%%%%%%%%%%%%%  %%%%%
%%%%%%%%%%%%%%%%%%%%%%%%%%  %%%%%
%%   %%%%%%%%%.%%%%%%%%%%%% %%%%%
%%   %%%%%%%%..%%%%%%%%%%%%  %%%%
%%   %%%%%%%%..%%%%%%%%%%%%  %%%%
%%   %%%%%%%%..%%%%%%%%%%%%  %%%%
%%   %%%%%%%%..%%%%%%%%%%%%  %%%%
%%   %%%%%%%%..%%%%%%%%%%%% %%%%%
%%   %%%%%%%%..%%%%%%%%%%%%%%%%%%
%%   %%%%%%%%%%%%%%%%%%%%%%%%%%%%
%%      %%%%..%%%%%%%%%%%%%%%%%%%
%%     %%%%%..%%%%%%%%%%%%%%%%%%%
%%    %%%%%%..%%%%%%%%%%%%%%%%% %
%%   %%%%%%%..%%%%%%%%%%%%%%%%  %
%%%%%%%%%%%%..%%%%%%%%%%%%%%%%%%%
%%%%%%%%%%%%..%%%%%%%%%%%%%%%%%%%
%%%%%%%%%%%%..%%%%%%%%%%%%%%%%%%%
%%%%%%%%%%%%..%%%%%%%%%%%%%%%%%%%
#
