%%%%%%%%%%%%%%
%%%%%%%%%%%%%%
%%%%%    %%%%%
%%%%%    %%%%%
%%%%% ........
%%%%% ........
%%%%% ........
%%%%%    %%%%%
%%%%%    %%%%%
%%%%%%%%%%%%%%
%%%%%%%%%%%%%%
#
%%%%%%%%%%%%%%
%%%%%%%%%%%%%%
%%%%%%%%%%%%%%
%%%P     ...%%
%%%     .....%
%%%     .....%
%%%     .....%
%%%      ...%%
%%%%%%%%%%%%%%
%%%%%%%%%%%%%%
%%%%%%%%%%%%%%
#
%%%%%%%%%%%%%%
%%%%%%%%%...%%
%%%%%%%%%...%%
%%%%%%%%%...%%
%%%%%%%%%...%%
%%       ...%%
%%       ...%%
%%%%%%%%%...%%
%%%%%%%%%...%%
%%%%%%%%%...%%
%%%%%%%%%%%%%%
#
