%%%%%%%%%%%%%%%%%%%%%%%%%%%%
%%%%%%%%%%%%%%%%%%%%%%%%%%%%
%%%%    %%%%%%%%%%%%%%%%%%%%
%%%%    %%%%%%%%%%%%%  %%%%%
%%%%    %%........%%   %%%%%
%%%%    %%.........    %%%%%
%%%%    %%........%%   %%%%%
%%%%    %%%%%%%%%%%%%  %%%%%
%%%%    %%%%%%%%%%%%%%%%%%%%
%%%%          %%%%%%%%%%%%%%
%%%%%%%%%%%%%%%%%%%%%%%%%%%%
%%%%%%%%%%%%%%%%%%%%%%%%%%%%
%%%%%%%%%%%%%%%%%%%%%%%%%%%%
%%%%       %%%%%%%%%%%%%%%%%
%%%%          %%%%%%%% %%%%%
%%%%                   %%%%%
%%%%                   %%%%%
%%%%        %%%%%%%%%%%%%%%%
%%%%%%%%%%%%%%%%%%%%%%%%%%%%
%%%%%%%%%%%%%%%%%%%%    %%%%
%%%%%%%%%%%%%%%%        %%%%
%%%%                    %%%%
%%%%                    %%%%
%%%%                    %%%%
%%%%%%%%%%%%%%%%%%%%%%%%%%%%
%%%%%%%%%%%%%%%%%%%%%%%%%%%%
#
%%%%%%%%%%%%%%%%%%%%%%%%%%%%
%%%%%%%%%%%%%%%%%%%%%%%%%%%%
%%%%%%%%%%%%%%%%%%%%%%%%%%%%
%%%      %%%....%%%%%%%%%%%%
%%%      %%%.....%%     %%%%
%%%      %%......%      %%%%
%%%      %%%.....%%     %%%%
%%%      %%%....%%%%%%%%%%%%
%%%       %%%%%%%%%%%%%%%%%%
%%%%%%%%%%%%%%%%%%%%%%%%%%%%
%%%%%%%%%%%%%%%%%%%%%%%%%%%%
%%%%%%%%%%%%%%%%%%%%%%% %%%%
%%%%%%%%%%%%%%%%%%%%%%  %%%%
%%%%%%%%%%%%%%%%%%%%%   %%%%
%%%           %%%%%%    %%%%
%%%P             %%     %%%%
%%%            %%%%%%%%%%%%%
%%%%%%%%%%%%%%%%%%%%%%%%%%%%
%%%%%%%%%%%%%%%%%%%%%%%%%%%%
%%%%%%%%%%%%%%%%%%%%%%%%%%%%
%%%%%%%%%%%%%%%%%         %%
%%%%%%%%%%%%%             %%
%%%                       %%
%%%%%%%%%%%%%%%%%%%%%%%%%%%%
%%%%%%%%%%%%%%%%%%%%%%%%%%%%
%%%%%%%%%%%%%%%%%%%%%%%%%%%%
#
%%%%%%%%%%%%%%%%%%%%%%%%%%%%
%%%%%%%%%%%%%..%%%%%%%%%%%%%
%%%%%%%%%%%%....%%%%%%%%%%%%
%%%%%%%%%%%%....%%%%%%%%%%%%
%%        %%....%%%%%%%%%%%%
%%        %%....%%%%%%%%%%%%
%%        %%....%%%%%%%% %%%
%%        %%....%%%%%%%% %%%
%%%%%%%%%%%%....%%%%%%%% %%%
%%%%%%%%%%%%%..%%%%%%%%% %%%
%%%%%%%%%%%%%%%%%%%%%%%% %%%
%%%%%%%%%%%%%%%%%%%%%%%% %%%
%%%%%%%%%%%%%%%%%%%%%%%% %%%
%%%%%%%%%%%%%%%%%%%%%%%  %%%
%%%%%%%%%%%%%%%%%%%%%%%%%%%%
%%%%%%%%%%%%%%%%%%%%%%%%%%%%
%%%%%%%%%%%%%%%%%%%%%%%%%%%%
%%%%%%%%%%%%%%%%%%%%%%%%%%%%
%%%%%%%%%%%%%%%%%%%%%%%%%%%%
%%%%%%%%%%%%%%%%%%%%%%%%%%%%
%%%%%%%%%%%%%%%%%%%%%%%%%%%%
%%%%%%%%%%%%%%%%%%%%%%%%%%%%
%%%%%%%%%%%%%%%%%%%%%%%%%%%%
%%%%%%%%%%%%%%%%%%%%%%%%%%%%
%%%%%%%%%%%%%%%%%%%%%%%%%%%%
%%%%%%%%%%%%%%%%%%%%%%%%%%%%
#
